WWWWWWWWWWWWWWWWWWWWWWWWWWWWW
WEEEEEEEEEEEEWWEEEEEEEEEEEEWW
WEWWWWEWWWWWEWWEWWWWWEWWWWEWW
WEWEEWEWEEEWEWWEWEEEWEWEEWEWW
WEWWWWEWWWWWEWWEWWWWWEWWWWEWW
WEEEEEEEEEEEEEEEEEEEEEEEEEEWW
WEWWWWEWWEWWWWWWWWEWWEWWWWEWW
WEWWWWEWWEWWWWWWWWEWWEWWWWEWW
WEEEEEEWWEEEEWWEEEEWWEEEEEEWW
WWWWWWEWWWWWEWWEWWWWWEWWWWWWW
EEEEEWEWWWWWEWWEWWWWWEWEEEEEW
EEEEEWEWWEEEEEEEEEEWWEWEEEEEW
EEEEEWEWWEWWWEEWWWEWWEWEEEEEW
WWWWWWEWWEWEEEEEEWEWWEWWWWWWW
EEEEEEEEEEWEEEEEEWEEEEEEEEEEE
WWWWWWEWWEWEEEEEEWEWWEWWWWWWW
EEEEEWEWWEWWWWWWWWEWWEWEEEEEW
EEEEEWEWWEEEEEEEEEEWWEWEEEEEW
EEEEEWEWWEWWWWWWWWEWWEWEEEEEW
WWWWWWEWWEWWWWWWWWEWWEWWWWWWW
WEEEEEEEEEEEEWWEEEEEEEEEEEEWW
WEWWWWEWWWWWEWWEWWWWWEWWWWEWW
WEWWWWEWWWWWEWWEWWWWWEWWWWEWW
WEEEWWEEEEEEEEEEEEEEEEWWEEEWW
WWWEWWEWWEWWWWWWWWEWWEWWEWWWW
WWWEWWEWWEWWWWWWWWEWWEWWEWWWW
WEEEEEEWWEEEEWWEEEEWWEEEEEEWW
WEWWWWWWWWWWEWWEWWWWWWWWWWEWW
WEWWWWWWWWWWEWWEWWWWWWWWWWEWW
WEEEEEEEEEEEEEEEEEEEEEEEEEEWW
WWWWWWWWWWWWWWWWWWWWWWWWWWWWW